Abaddon = Lord of Avernus
Alchemist = Razzil Darkbrew, Alch
Ancient Apparition = Kaldr, AA
Antimage = Magina, AM
Arc Warden = Zet
Axe = Mogul Khan, Khan
Bane = Antropos
Batrider = Jinzakk, Bat
Beastmaster = Rexxar, BM
Bloodseeker = Strygwyr, BS
Bounty Hunter = Gondar, Bounty, BH
Brewmaster = Mangix, Brew, Panda
Bristleback = Rigwarl
Broodmother = Black Arachnia, Brood
Centaur Warrunner = Bradwarden, Centaur, Cent
Chaos Knight = Nessaj, CK
Chen = Holy Knight
Clinkz = Bone Fletcher, Bone
Clockwerk = Rattletrap, Clock, CW
Crystal Maiden = Rylai, CM
Dark Seer = Ishkafel, DS, Seer
Dark Willow = Mireska Sunbreeze, DW, Willow
Dazzle = Shadow Priest
Death Prophet = Krobelus, Krob, DP
Disruptor = Thrall, Stormcrafter
Doom = Lucifer, Luci, Doom Bringer
Dragon Knight = Knight Davion, DK
Drow Ranger = Traxex, Drow
Earthshaker = Raigor Stonehoof, Shaker
Earth Spirit = Kaolin
Elder Titan = Worldsmith
Ember Spirit = Xin
Enchantress = Aiushtha, Enchant, Chantress, Chuan
Enigma = Darchrow, Consumer of Worlds
Faceless Void = Darkterror, Void, FV
Grimstroke = Jerry, Bob Ross
Gyrocopter = Aurel, Gyro
Huskar = Scared Warrior, Husk
Invoker = Kael, Voker, Carl
Io = Wisp, Beep Boop
Jakiro = Twin Head Dragon, Jak, THD
Juggernaut = Yurnero, Jugg
Keeper of the Light = Ezalor, KOTL, Keeper
Kunkka = Admiral
Legion Commander = Tresdin
Leshrac = Tormented Soul, Lesh
Lich = Kelthuzad
Lifestealer = Naix
Lina = Slayer
Lion = Demon Witch
Lone Druid = Syllabear, Sylla, Bear, Druid
Luna = Moon Rider
Lycan = Banehallow, Lycanthrope
Magnus = Magnataur, Mag
Medusa = Gorgon, Dusa
Meepo = Geomancer, Geo
Mirana = Priestess of the Moon, POTM
Monkey King = MK, Sun Wukong, Wukong
Morphling = Morph
Naga Siren = Slithice, Naga, Siren
Natures Prophet = Furion, Prophet, NP
Necrophos = Necrolyte, Rotundjere, Necro
Night Stalker = Balanar, NS
Nyx Assassin = Anubarak, Nyx
Ogre Magi = Aggron Stonebreaker, Ogre
Omniknight = Purist Thunderwrath, Omni
Outworld Devourer = Harbringer, OD, Outworld Destroyer
Pangolier = Pango, Donte Panlin, Donte
Phantom Assassin = Mortred, PA
Phantom Lancer = Azwraith, PL
Phoenix = Chicken, Caw
Puck = Faerie Dragon
Pudge = Butcher
Pugna = Oblivion
Queen of Pain = Akasha, QoP
Razor = Lightning Revenant
Riki = Stealth Assassin
Rubick = Grand Magus
Sand King = Crixalis, Crix, SK
Shadow Demon = Eredar, SD
Shadow Fiend = Nevermore, SF
Shadow Shaman = Rhasta, Shaman, SS
Silencer = Nortrom
Slardar = Slithereen Guard, Slar
Slark = Murloc, Nightcrawler
Sniper = Kardel Sharpeye, HOHO, HAHA, HOHO HAHA
Spectre = Mercurial
Spirit Breaker = Barathrum, Bara, SB
Storm Spirit = Raijin Thunderkeg, Storm, SS
Sven = Rogue Knight
Templar Assassin = Lanaya, Templar, TA
Terrorblade = TB, Demon Marauder
Tidehunter = Leviathan, Tide
Timbersaw = Goblin Shredder, Rizzrak
Tinker = Boush, Tink
Tiny = Stone Giant
Treant Protector = Rooftrellen, Treant
Tusk = Ymir, Snowball from Cobalt, Terror from the Barrier
Underlord = Pitlord, Vrogros, Abyssal Underlord, Azgalor
Undying = Dirge
Ursa = Fuzzy Wuzzy, Ulfsaar, Ursa Warrior
Vengeful Spirit = Shendelzare, Venge, VS
Venomancer = Veno, Lesale Deathbringer, Lessie
Viper = Netherdrake
Weaver = Skitskurr
Wraith King = Leoric, WK, Skeleton King
